...****************************************************************************************
...*..*........*.....*........*..*.................*..*.....*.....*........*.....*.....*..*
*..*..*..****..*..****..*******..****..*..*..****..*..*..*..*..*..*..****..*..*******..*..*
*...........*..*..*........*..*........*..*..*.....*..*..*..*..*........*.....*...........*
*..*************..*..*******..*..**********..*..*..*..****..****..*..**********..*..****..*
*........*.....*...........*.....*...........*..*..*........*.....*..............*..*..*..*
****..*..*..*******..****..*************..*******..*..*******..*..*..****..*******..*..*..*
*.....*.................*..*..............*..*..............*..*..*..*.....*.....*..*.....*
*..****************************************..*******..****..*************..*..*..*..*******
*..*..*..*........*........*..............*..............*........*........*..*..*........*
*..*..*..*..****..****..*..*******..**********..*..**********..*..*******..*..****..*..****
*..*........*.....*.....*..*.....*.....*........*..*.....*..*..*..*..*..*.....*.....*.....*
*..*..**********..****..*..*..*******..****..*..****..****..****..*..*..*..**********..****
*.....*..*.....*........*..*...........*.....*..*..*.....*..*.......................*.....*
****..*..****..*************..*******..**********..*..*..*..*..****..*..****..*..****..****
*.....*.....*..*.....*.....*........*........*..*.....*..*........*..*.....*..*..*..*..*..*
*..****..*..*..*..*..****..*..*************..*..****..****..**********..**********..****..*
*.....*..*..*..*..*........*...........*...........*..*..*.....*..*........*.....*........*
****..****..*..*..*******..****..**********..*..****..*..*..****..*******..*..*..*******..*
*..............*..*........*..............*..*..*........*..*.................*..*..*.....*
*******..*************..****..****..****..****..*..*************..****..****..****..****..*
*..*..*.....*........*..*........*..*..*..*.....*........*...........*..*..*..*..*........*
*..*..*..****..*..****..*******..****..**********..**********..*..****..*..****..*..****..*
*..............*..*..*...........*.....*....................*..*..*..*.....*...........*..*
*..****..*..*..****..*..*..*******..**********..*..*******..****..*..*..*******..*******..*
*..*.....*..*..*........*..*........*...........*.....*..*..*.....*....................*..*
*..*******..*******..****..*..****..*..**********..*..*..*..****..*************..*..****..*
*.....*..............*.....*..*...........*..*.....*..*...........*..*..*..*..*..*..*.....*
*..*..****..*..*..*******..****..*..*******..*************..*..****..*..*..*..**********..*
*..*..*..*..*..*.....*.....*.....*...........*..*...........*..*........*.....*........*..*
*..****..****..**********..*..*******..*..****..*******..*..*..*******..*..****..*******..*
*..*....................*.....*........*..*........*..*..*..*.....*..............*..*.....*
**********..*..*..****..****..**********..*..*..*..*..****************..*******..*..*..****
*...........*..*..*.....*..*........*.....*..*..*.................*.....*..*.....*..*..*..*
*******..****..****..****..*..*******..*..****..*******..*..*..****..****..****..*..*..*..*
*........*........*..*.....*..*..*..*..*...........*..*..*..*..*........*.....*...........*
*..*******..*******..*..****..*..*..*******..****..*..*..****************..*..****..*******
*..*...........*...........*..*........*..*.....*..*.....*..*...........*..*..*........*..*
*******..*************..**********..****..****..*..*..*..*..*..*******..*..*..*..*******..*
*.....*.....*.....*........*........*..*........*..*..*.....*..*.....*.....*..............*
*..*..*..*******..****..****..*******..*..*******************..****..**********..*******..*
*..*.....*...........*.....*...........*...........*.....*........*........*..*..*........*
*..*..*..*..*******..*..*******..*..****..*..**********..*******..****..*..*..*******..*..*
*..*..*........*.....*..*.....*..*.....*..*.....*........*..*...........*.....*........*..*
****..*..****************..*******..****..*..*..*..*..****..*..****..**********..****..****
*..*..*........*.....*..*........*........*..*..*..*..............*..*........*..*........*
*..*..****..****..****..*..*************..****..****..*************..*..*..**********..*..*
*..*..*...........*..*.....*..*.....*.....*........*........*...........*.....*........*..*
*..*..**********..*..*..****..****..*..****..**********..*******..*******..****..****..****
*........*.....*..............*........*..*..*.....*..*.....*..*..*.....*..*..*..*........*
*************..*..****************..****..*..*..****..*******..*..*..****..*..*******..****
*..*..............*.....*..*..............*..............*..*........*.....*..............*
*..*..*..*************..*..*******..****..*..****..****..*..*..*******..*..*..*..*******..*
*.....*..*.....*........*........*..*..*..*.....*..*..*..*..*..*..*.....*..*..*.....*.....*
*************..****..*******..*..*..*..*************..****..****..*..*..****..*******..*..*
*..*..*.....*...........*.....*.....*.....*........*...........*.....*..*..*..*..*.....*..*
*..*..****..****..****..*..****..*..*..*..*..*******..*..*..*..*******..*..****..*..*******
*.....*..*.....*.....*.....*.....*.....*.....*........*..*..*.....*..*.....*..*..*........*
*..*..*..****..*******..****..****..****..*..*******..*************..****..*..*..*******..*
*..*.....*..*..*.....*.....*..*.....*.....*..............*..*.....*..*..*..*..............*
*..*******..*..****..*************..****..****..**********..*..*..*..*..*..*..*******..****
*........*..*.....*.....*.....*..*.....*..*..*.....*..*........*........*..*..*.....*.....*
*..*******..*..*******..*..****..*..****..*..****..*..**********..*..****..****..*******..*
*..............*..*..*..*..*..*.....*...........*........*..*.....*.....*..*........*..*..*
*************..*..*..*..*..*..*..*..*******..*******..****..****..****************..*..*..*
*..*..*.....*.....*........*.....*..*..*..*.....*........*.....*........*........*........*
*..*..*..****..**********..****..****..*..*..****..**********..****..*******..*..*..****..*
*..*...........*..*..*..*..*.....*...........*........*.................*.....*..*.....*..*
*..*..**********..*..*..*..****..****..**********..**********..****..****..****..*..*..****
*........*........*........*.....*.....*........*.....*...........*.....*..*..*.....*.....*
****..****..*******..*..****..****..*..*..****..*..*..*..*..****..*..*..****..****..****..*
*.....*........*..*..*..*.....*..*..*..*.....*..*..*.....*..*.....*..*..*..*.....*..*.....*
****..****..****..*..*..*..*..*..*******..*..*******..*******..****..****..****..*..*..****
*........*........*..*.....*...........*..*..*..............*..*...........*..*..*..*..*..*
****..*..****..****..*..**********..*..*..****************..*..*..*..*..*..*..*..*..*..*..*
*.....*........*.....*........*.....*.....*..*........*..*..*..*..*..*..*..*..*.....*..*..*
*******..*******..**********..**********..*..****..*..*..*..****..**********..*..*******..*
*..*........*..*.....*.....*..*.....*..*..*..*..*..*.....*..*...........*..............*..*
*..*..*******..****..*..*..*..*..****..****..*..*******..*******..*******..*..****..*..*..*
*..*..*..*..............*..*...........*........*..*...........*.....*..*..*..*.....*.....*
*..*..*..*..*..*************..****..*******..****..*..****..****..****..*..****..**********
*...........*..*........*.....*.....*.....*...........*..*........*...........*..*..*.....*
*..****..*..*..****..****************..*..*******..*..*..*..*************..****..*..****..*
*..*.....*..*..*..*.....*.....*..*.....*........*..*.....*........*........*.....*........*
*******..****..*..****..*..****..****..*************..*..****************..**********..****
*........*.....*....................*........*..*.....*........*........*........*........*
*******..**********..****..****..*******..*..*..*..*******..****..*..*..**********..*..****
*..*........*...........*.....*...........*..*........*.....*.....*..*..*...........*..*..*
*..*******..*..*******************..*..*..****..****..*******..**********..**********..*..*
*..*..*.....*..*........*.....*..*..*..*.....*.....*..*........*.....*...........*.....*..*
*..*..*..*..*..*******..*..*..*..*..*..****..*..*..*..*..*..*..****..*..*******..****..*..*
*..*..*..*..*.....*..*..*..*........*..*.....*..*..*.....*..*.....*...........*.....*.....*
*..*..****..****..*..*..*************..****..****..*..*..****..****..*******..****..****..*
*..*..*..*..*..*.....*..*..*..............*........*..*..*.....*.....*...........*..*.....*
*..*..*..****..*..****..*..*************..****************..*..*..*******..**********..****
*..*..*...........*..*..*...........*.....*...........*.....*........*..*........*.....*..*
*..*..*..*..****..*..*..*..****..****..****..****..**********..*..*..*..****..**********..*
*.....*..*.....*.....*........*.....*.....*..*........*........*..*.....*.....*...........*
*..*..*..*..*******..*..****..*******..*******..*..*..****..*******..*******..*..*******..*
*..*.....*.....*........*.....*.................*..*.....*.....*...........*.....*........
****************************************************************************************..
