...****************************************************************************************
...............*........*.....*........*........*.................*..*..*..*..............*
*..*..*..**********..****..****..****..****..*..*..****..**********..*..*..*..****..****..*
*..*..*.................*........*.....*.....*..*..*..*.....*.....*...........*..*..*..*..*
*..****..****..****..*..****..****..****..*..****..*..*******..*..****..*..****..****..*..*
*.....*.....*..*.....*........*...........*...........*.....*..*........*........*..*.....*
*************..*..*************..****..*..*******..*..****..*..*..*..*******..****..*..****
*.....*..*..*..*........*..*.....*..*..*........*..*........*..*..*........*........*..*..*
*..****..*..*******..*..*..****..*..**********..*******..****..*..****..****..*..*..****..*
*.....*.....*..*..*..*........*.....*........*..*..*........*..*..*..*..*.....*..*..*.....*
****..*..****..*..*..*******..*..****..*******..*..*******..*..****..*..****..*..*******..*
*...........*..*..*.....*.....*........*.....*........*..............*..*.....*.....*..*..*
*..**********..*..*..*******..**********..****..*..*******..****..*******..**********..*..*
*...........*..*........*..*..*........*..*.....*.....*........*........*........*........*
****..*..****..****..*..*..****..*******..**********..****..*..****..*..*******..*..****..*
*.....*..*..*.....*..*.....*.....*...........*........*.....*..*.....*........*........*..*
*******..*..****..*..*******..*..*..*..*..****..*..****************..*..*******..****..*..*
*........*..*...........*..*..*..*..*..*.....*..*........*...........*.....*..*.....*..*..*
*..*******..*..**********..*..*..*******..*******..*..*******..**********..*..****..****..*
*.....*...........*.....*.....*.....*..............*..*.....*.....*..*..*..*.....*..*.....*
****..*..****..*..*..*******..*******..*..****..*******..*..*..*..*..*..****..*************
*.....*..*.....*..*...........*........*..*.....*..*.....*..*..*..*........*..*.....*..*..*
****..*******..**********..*..*..*************..*..****..****..*..****..****..****..*..*..*
*.......................*..*.................*..*..*..*..*..*..*..*.....*........*.....*..*
*..*..****************..****..*..**********..****..*..*..*..****..*..****..*..*..*..*..*..*
*..*.................*..*.....*..*..*..*..*..............*..*..............*..*.....*..*..*
*..*..****..*******..*..**********..*..*..*..*..**********..*..*************..****..*..*..*
*..*..*.....*..*..*..*.....*.................*..*.....*..*..*..*..*..*........*.....*.....*
*..*******..*..*..****************..*******..****..****..*..*..*..*..**********..****..****
*..*.....*...........*..*........*..*..*...........*.....*.....*...........*..*.....*.....*
*..****..*************..*..****..*..*..*..*************..*..*******..*..****..*******..*..*
*....................*........*..*..*..*.....*.....*..*.....*.....*..*...........*.....*..*
*..*..*******..*************..****..*..*******..*..*..*..*******..*..*..*..*******..*..*..*
*..*..*..............*...........*..*........*..*..*..*...........*..*..*........*..*..*..*
*..*..*..****..****..****..****..****..*******..****..*..****..****..**********..*..*******
*..*..*..*........*.....*..*....................*..*.....*..*.....*..*..............*..*..*
*************..*..*..**********..****..**********..*..****..*..*******..*************..*..*
*.....*..*.....*..*........*........*..*.....*........*..*..*..*..*.....*.....*..*..*..*..*
****..*..*..****..****..*******..****..*..*..****..*..*..*..****..**********..*..*..*..*..*
*..*.....*..*.....*........*..*..*........*..*..*..*.....*..*...........*..*...........*..*
*..*..*************..****..*..*******..****..*..****..*..*..*..**********..*******..****..*
*..*.....*..*........*..*..............*........*..*..*.....*..............*..............*
*..****..*..*..*..*..*..*..*..*************..****..*..*..****..**********..*..**********..*
*..............*..*.....*..*..*...........*..*..*..*..*.....*..*..*........*........*.....*
*..****..****..*******..*..****..**********..*..*..****..*******..****..*************..****
*.....*.....*.....*..*..*...........*..............*.......................*..*.....*..*..*
****..*******..****..**********..*******..*******..****..*******..*..*******..****..*..*..*
*.....*...........*.....*.....*.....*..*........*.....*..*..*..*..*..*..*........*........*
*******..*******..****..****..*..****..****..*******..*..*..*..*..*..*..*******..****..*..*
*.....*..*..*........*.....*...........*..*..*..*.....*..*.....*..*..*..............*..*..*
****..****..*******..****..*..*******..*..****..*******..****..*..*******..**********..****
*...........*........*.....*........*..*..*..*.....*...........*.....*..*..*..............*
*..*..*************..****..****..****..*..*..*..*..*..****..****..****..*..*..*..*..*..****
*..*...........*..............*..*..............*..*..*.....*..............*..*..*..*..*..*
*..*..****..*..*******************..*..*..*..*************..****..*******..*..****..*..*..*
*..*..*..*..*.....*........*........*..*..*........*.....*..*..*........*..*..*.....*.....*
*..****..****..****..*..****..*************..*..****..****..*..****..*..****..**********..*
*.....*..*.....*..*..*........*..*..*........*........*........*..*..*........*...........*
*..****..****..*..****..****..*..*..*******..*..****************..*******..****..*******..*
*...........*..............*.....*..*........*..*..*........*.....*.....*.....*..*..*.....*
*******..*******..****..*..****..*..****..****..*..*..****..****..*..*..*******..*..*..*..*
*........*........*..*..*..*.....*.....*..*..*..*........*........*..*..*.....*..*.....*..*
****..*******..****..*..****..*..****..*..*..*******..*..*************..****..*..*..*..*..*
*.....*.....*........*..*.....*..*..*.....*........*..*..*.................*..*..*..*..*..*
*..****..*******..****************..****..*..*..****..****..*..*..****..*..*..**********..*
*.....*.....*........*.................*.....*...........*..*..*..*.....*.....*........*..*
**********..*..****..*..****..*******..****..*..*..*..*******..*..**********..****..*******
*.....*...........*..*..*..*.....*...........*..*..*.....*.....*...........*.....*........*
*..**********..*..*******..*******..*************..****..**********..****..**********..*..*
*..............*.....*...........*........*...........*...........*..*........*........*..*
*******..**********..*******..*..*******..**********..*..****..****..*******..****..*******
*.....*...........*........*..*..*..*..*.....*.....*..*.....*........*.....*..*.....*..*..*
*..*******..*******..*******..****..*..*..*..*..****..*******..*..*..*..*..*..****..*..*..*
*..*..*........*.....*.................*..*.....*...........*..*..*..*..*..*.....*........*
*..*..*..****..****..*..*******..**********..****************..*..*******..****..*..*..*..*
*..*.....*..*.....*.....*........*..*....................*.....*..*.....*..*.....*..*..*..*
*..*..*..*..****..****..****..****..*************..*******..**********..*..*..*..*******..*
*.....*..*........*.....*.....*........*..*...........*...........*...........*.....*.....*
*..*..**********..**********..*..*******..*..*..*************..*******..****..*..****..*..*
*..*..*........*.....*.................*..*..*..*.....*..*........*..*..*.....*........*..*
*..****..**********..****..****..*..*..*..*..*******..*..*..*******..*..*..****..****..****
*.....*..............*..*..*..*..*..*.....*...........*.....*........*..*..*.....*..*..*..*
****..****..*..*..****..****..*..*..*..**********..****************..****..*******..*..*..*
*.....*.....*..*...........*.....*..*..*..............*.....*...........*........*........*
*..*..*..*..****..*..**********..*..****..*..*..*******..**********..****..****************
*..*..*..*..*.....*.....*.....*..*.....*..*..*..*.....*..*..*.....*........*..*........*..*
*************..****..*******..**********..*..****..*..*..*..****..*******..*..*..*..*..*..*
*..*..*........*.....*.....*..*..*..*..*..*........*........*..*.....*..*........*..*.....*
*..*..*******..****..*..*..*..*..*..*..****..****..****..****..*..****..*..****..*******..*
*..............*..*.....*.....*.....*........*..*..*.....*...........*.....*.....*........*
*..****..*..****..*******..****..*************..*..*..****..****..*..****..****..*..****..*
*..*.....*..*.....*..*..*.....*.....*...........*..*...........*..*..*.....*.....*..*..*..*
*..*..****..*..****..*..****..*..**********..****..*************..****..**********..*..****
*..*..*..............*........*..............*..............*........*...........*........*
*******..*******..*************..**********..*******..*..*************..*******..****..*..*
*..*..*..*..*...........*..*........*...........*.....*..............*.....*........*..*..*
*..*..*..*..*..*******..*..*..*************..*..*******..*******..*..**********************
*..*.....*..*........*..*..*.....*..*..*..*..*.....*..*.....*.....*.....*..*..*........*..*
*..*..****..****..*******..****..*..*..*..*..*..****..*..*******..*..****..*..*******..*..*
*..............*..............*..*...........*...........*........*.......................
****************************************************************************************..
