...****************************************************************************************
......*..*........*..*.....*..*...........*...........*..*.....*..*........*..............*
*..****..*..*..****..*..****..**********..*******..*..*..****..*..****..*******..****..*..*
*..*........*.....*.....*..*..*........*..*..*.....*..*..............*.....*..*..*..*..*..*
*..****..****..****..****..*..*..****..*..*..*******..*..*..*******..****..*..*..*..*..****
*..*.....*.....*.....*..*........*..*..*...........*..*..*.....*..*.................*.....*
*..*******..*******..*..*******..*..****..*..*..****..*******..*..*..*..*******..*******..*
*..*..*.....*..*.....*.....*..............*..*..............*.....*..*........*..*..*..*..*
*..*..*..*..*..****..*..****..****..*..****************..*..*..****************..*..*..****
*.....*..*.....*.....*..*.....*..*..*........*.....*..*..*.....*..*..*....................*
****..****..*******..*..****..*..*******..*..*..****..**********..*..*..*..****..****..****
*..*..*...........*.....*.....*........*..*.....*........*........*..*..*.....*.....*.....*
*..*..*..****..*..****..**********..****..****..****..*..****..*..*..*..*..**********..*..*
*...........*..*..*..*.....*.....*..*.....*..*.....*..*.....*..*.....*..*.....*..*.....*..*
*..*******..*..****..*..*******..*..*..*..*..*..*..****..*..****..**********..*..*******..*
*..*........*........*.....*...........*.....*..*..*.....*........*..............*..*..*..*
*..*..**********..*..*..*******..****..*..*******..****..**********..*..**********..*..*..*
*..*........*..*..*..*........*..*.....*..*..*...........*...........*........*.....*.....*
*******..*..*..*..**********..*************..*..*..****..****..**********..*******..****..*
*........*..*.....*.....*........*.....*..*..*..*..*.....*........*..*........*.....*..*..*
*..****..****..*..****..*..*..*..*..*..*..*..*..*..**********..*..*..*******..*..****..*..*
*..*.....*..*..*........*..*..*.....*........*..*.....*........*..*..*..............*.....*
*..****..*..*******..****..****..****..*..****..****..*******..****..****..****..**********
*..*.....*.....*..*........*.....*..*..*........*..*.....*..*..*.....*.....*..............*
****..*..*..*..*..****************..****..****..*..*******..****..****..*******..*******..*
*..*..*.....*.....*.....*.....*........*.....*..*.....*........*..*.....*..*..*..*..*.....*
*..*..*******..*******..*..*******..*******..*******..*..****..*..*..****..*..*..*..*..*..*
*..*.....*........*.....*..*..*.....*..*.................*.....*.....*..*........*..*..*..*
*..*******..****..*..*..*..*..****..*..*******..*..****..*..****..****..****..****..*******
*........*.....*..*..*.....*.....*........*.....*.....*..*..*........*..*........*........*
****..*..*..*..****..****..*..****..*************..*..*******..*******..*************..****
*..*..*.....*........*.................*.....*..*..*.....*.....*..........................*
*..****..*..****..*******..*..*******..*..*..*..****..*..*******..*..****..**********..****
*.....*..*..*........*.....*..*.....*.....*..*.....*..*..*.....*..*..*........*...........*
****..*******..*************..*..*******..****..****..*..****..****..****..*******..*..*..*
*.....*.....*.....*.....*.....*.....*...........*..*..*..............*..*........*..*..*..*
*..*******..*******..*******..*..*..*******..*..*..*..****..****..****..*..**********..****
*........*.....*.................*..*........*..*..*.....*.....*.....*........*.....*.....*
*..*..****..****..****..*******..*..****..*..*..*..**********..*******..****..****..*..****
*..*.....*..*........*........*..*..*.....*..*..*..*.....*...........*..*.....*........*..*
*..*******..****..*******..*..*******..*..*******..*..****************..*..*************..*
*..*.................*.....*..*..*.....*.....*........*.....*...........*..*.....*........*
*..*******..*..*..*******..****..****..*******..*..****..****..*..*******..*..*******..****
*..*.....*..*..*.....*.....*...........*........*...........*..*........*..*........*.....*
*..*..****..****..****..*******..****..*******..*..*..****************..*..****..*******..*
*...........*.....*..*..*........*.....*.....*..*..*.....*..*..*..*..*..*..*..............*
*..*************..*..*..*..****..*..****..*******..*******..*..*..*..*..*******..**********
*..*..*........*..*.....*..*..*..*.....*........*..............*..*........*..*...........*
****..*..*******..****..****..*******..*..*..*************..*..*..*..*..*..*..****..*..*..*
*..............*..*........*........*.....*..*.....*..*.....*..*.....*..*..*..*.....*..*..*
****..*..*..*..**********..*******..*..*..*..****..*..*..*..*******..****..*..*******..****
*.....*..*..*........*..*..*..*.....*..*..*..*..*........*..*........*........*...........*
****..*******..*..*..*..****..****..*..*..****..*..**********..**********..*******..****..*
*........*..*..*..*..*........*.....*..*........*........*..............*.....*.....*.....*
**********..****..****..**********..*..****..****..*..*******..*************..*..**********
*........*.....*.....*..*.....*..*.....*.....*..*..*........*.....*.....*..............*..*
****..*******..*..*..*..****..*..*******..****..*..*..*..*..**********..****..*******..*..*
*..*.....*.....*..*..*..*.....*........*..*..*.....*..*..*..*.....*.....*...........*.....*
*..****..****..*..****..****..****..****..*..*..*..*..**********..****..****..*******..****
*..*.....*.....*..*..*...........*..*.....*.....*..*....................*........*........*
*..*..*..*..****..*..**********..*..*******..*************..*******..*..*..*..*******..****
*.....*..............*..............*.....*...........*..*.....*..*..*.....*.....*.....*..*
*..****..*..****..****..**********..****..*******..****..*******..*..*..*..*******..****..*
*..*.....*..*.................*..............*.................*.....*..*.....*........*..*
****..****..*..*************..**********..****..****..*..*..****..*******..*************..*
*.....*..*..*.....*..*........*..*..............*..*..*..*..*...........*........*..*.....*
*..*..*..*..*******..****..*..*..*******..****..*..*******..*..****..****..****..*..****..*
*..*..*...........*.....*..*........*.....*.....*.....*.....*.....*.....*..*..............*
****..**********..*..*..*..*******..*******..****..*..****..*******..****..*..*..**********
*...........*..*..*..*..*.....*.....*..*.....*..*..*.....*.....*..*..*.....*..*..*..*.....*
*..*..*******..*..****..*************..****..*..****..**********..****..*..*******..****..*
*..*........*...........*........*.....*..*...........*..*...........*..*..*........*.....*
*..*..**********..*************..****..*..*..*..*******..****..*..*************..****..*..*
*..*..*....................*..............*..*........*.....*..*..*....................*..*
*..**********..****..*************..****..*******..*..*..****..****..*************..*******
*...........*..*..*..*...........*..*..*.....*.....*..*..*........*..*...........*..*..*..*
*..*******..****..*..*..****..****..*..**********..****..****..****..****..****..****..*..*
*.....*........*........*..*..*.....*.....*..*..*..*.....*..*..*...........*..*........*..*
*..*************..*******..*..*..****..****..*..*..****..*..*..*..*..*******..****..****..*
*..*.....*..*..*........*.....*.....*.....*.....*........*..*.....*..*...........*.....*..*
*..*..****..*..*..****..*******..*******..****..**********..*..*..*..*******..*******..*..*
*........*.....*..*.....*.....*..*...........*.....*..*........*..*..............*..*..*..*
*..**********..**********..****..*..****..****..****..*******..*************..*..*..****..*
*...........*.....*...........*........*...........*...........*.....*.....*..*..*..*.....*
*..*..*..*..****..****..*..*..****..*..**********..****..*******..*..****..*..****..*..****
*..*..*..*...........*..*..*..*.....*..*..*.....*..*.....*..*..*..*........*..*..*.....*..*
*******..*******..*******..*..*..****..*..*..*..**********..*..*..**********..*..****..*..*
*........*.....*.....*.....*..*.....*........*..*..............*........*........*..*.....*
*******..*..*..*..*******..*..****..****************..*************..*..*..*******..*..****
*........*..*..*........*..*.......................*..*...........*..*...........*........*
*******..****..****..**********..*******************..*..*******..*******..*..*..*..*..****
*........*.....*........*........*.....*..*..............*..*........*..*..*..*.....*..*..*
*..*******..*************..*******..****..*..****..*******..*..*..*..*..*..*******..****..*
*..*..*.....*..*.................*.....*.....*.....*..*........*..*..*.....*..............*
*..*..*..*..*..*..*..*..*******..*..****..*..*******..*******..*..*..*..*..****..****..****
*........*........*..*..*..*..............*..*.....*..*.....*..*..*.....*..*........*.....*
*..****..**********..****..*..*..****..****..*..*..*..*..*..*..****..*******..**********..*
*.....*...........*..*.....*..*..*........*..*..*........*.....*..*..*........*..*.....*..*
****..*..*..*..****..*..*..*..*..*..****..****..*..*******..*..*..*******..****..*..****..*
*.....*..*..*.....*..*..*.....*..*..*.....*.....*.....*.....*..*..............*...........
****************************************************************************************..
