...****************************************************************************************
...*.....*..*....................*........*..*..*........*.....*.....*..*..*.....*........*
*..****..*..****..****..*..****..****..*..*..*..*..****..****..*..****..*..*..*..*..****..*
*..*.....*.....*..*..*..*..*.....*..*..*........*..*..............*..*........*.....*.....*
*..****..*..*..*..*..*..**********..*******..*..*..****************..****..*..**********..*
*..*........*..*..*.....*........*..*..*..*..*...........*..*..*.....*.....*.....*........*
*..*..****..****..**********..****..*..*..****..*******..*..*..*..****..****************..*
*..*..*...........*.....*..*..........................*..*..*..*.....*..*...........*.....*
*..*..****..*******..****..*..**********..****..**********..*..*..*..*******..**********..*
*.....*..............*...........*........*.....*..*..*.....*.....*.......................*
*..*******..*..**********..*..**********..*******..*..*..****..*..*..*******..****..*..*..*
*..*..*.....*........*.....*..*..*..*..............*..*.....*..*..*..*..*..*..*.....*..*..*
****..*..*******..*..**********..*..*..*******..****..*..*..*******..*..*..*******..*******
*.....*.....*.....*..*........*..*..*.....*........*.....*..*.....*.....*........*..*..*..*
****..*..*..****************..*..*..*..*******..****..****..*..*..*..****..****..****..*..*
*..*.....*..*........*.....*.....*..*..*..*..............*.....*...........*..*.....*..*..*
*..*..*************..****..*..****..****..*******..*******..****************..*..*..*..*..*
*...........*..*..*.....*........*.................*........*..*..*........*.....*........*
*..*******..*..*..****..****..*..*..*..*..**********..*..****..*..*******..*..*************
*.....*.....*........*........*.....*..*..*..*..*..*..*........*..*.................*..*..*
*..*..*..*..****..**********..*******..****..*..*..*..**********..*******..*..*******..*..*
*..*..*..*........*..*..*.....*.....*..............*..*..*.................*...........*..*
****..**********..*..*..*..*..****..*..****..****..*..*..****..****..*************..****..*
*.....*.................*..*........*.....*..*.....*.....*.....*...........*...........*..*
*..**********..*..*..*..*******..*..*..*******..****..**********************..*..*******..*
*.....*..*.....*..*..*..*........*..*..*..*..*.....*.....*.....*.....*..*..*..*..*.....*..*
*..****..****..****..****..*..*..*..*..*..*..*..*************..****..*..*..*******..*..*..*
*.....*..*........*..*.....*..*..*..*..*.................*..*........*..*..*........*..*..*
****..*..****************..*******..****..*..*..*******..*..*..****..*..*..**********..*..*
*..*..*.....*..*..*........*........*..*..*..*.....*...........*..*..*.....*........*.....*
*..*..*..*..*..*..****..*..*******..*..*..*******************..*..****..****..*..*******..*
*........*..............*..*........*..*..*........*..*...........*........*..*...........*
*******..*******..*..*..****..****..*..**********..*..*..****..****..****..*******..****..*
*..............*..*..*.....*..*..*.....*..*..*..*..*.....*.....*..*..*........*.....*.....*
*..****..****..****************..*..*..*..*..*..*..*..**********..*..*******************..*
*..*........*.....*.....*..*........*.....*.....*..*..............*..*.....*..*.....*.....*
****..****..*..*..*..****..*..*..****..****..****..**********..****..****..*..****..****..*
*.....*.....*..*..*.....*.....*.....*..*........*..............*.....*.....*........*.....*
*******..*******..****..****..**********..****..**********..*..*..*..*..****..*..*..****..*
*.....*..*..*...........*........*..*..*..*.....*..*........*..*..*.....*.....*..*.....*..*
*..*..****..*..**********..*..*..*..*..****..*..*..****..*************..*..*..****..****..*
*..*.....*..............*..*..*..*..*..*.....*..*........*..*........*.....*..*...........*
*..*..*************..*******..*..*..*..*..*..**********..*..****..*..****..*..*..****..****
*..*........*..*.....*.....*..*........*..*..*.....*..............*..*..*..*..*..*.....*..*
*..**********..*..*..*..*..*..****..****..****..*..*******..**********..**********..*..*..*
*........*........*..*..*..*..*..............*..*....................*..............*.....*
*..****..*************..****..*..*..****..****************..*..*************..*************
*.....*.....*...........*..*..*..*..*........*.....*........*..*..*........*..*..*.....*..*
*..*..*..*..*******..****..*..*..*..*..*******..*..*..*..****..*..*..*******..*..*..*..*..*
*..*..*..*..*.....*...........*..*..*........*..*.....*.....*.....*..*........*.....*.....*
*..*******..*..*..****..*************..*******************..****..*..*..*..*..*******..*..*
*........*.....*.................*........*.....*.....*..*..*........*..*..*...........*..*
*..*************..*..**********..****..*******..****..*..*..*******..****..****..*******..*
*.....*..*..*.....*.....*..*..*..*.......................*..*........*..*..*.....*..*.....*
*..****..*..****..*..****..*..**********..*******..*..*..*******..****..****..****..*******
*..............*..*.....*..............*..*.....*..*..*.....*........*........*........*..*
*******..****..**********..****..*******..*..*..*..**********..*..*******..****..*..*..*..*
*..*..*..*.....*...........*.....*........*..*..*........*..*..*.................*..*.....*
*..*..*..*******..****..*******..*******..*..*******..*..*..*..*..*..*..****************..*
*..*........*..*..*...........*.....*..............*..*.....*..*..*..*.....*........*.....*
*..****..****..*******..****..*..*..*..*******..****..*..**********..****..****..****..****
*...........*.....*..*..*.....*..*...........*..*.....*...........*..*.....*..............*
*..**********..*..*..*******..*..*..**********************..****..*************..****..*..*
*...........*..*..............*..*........*........*........*.....*.....*........*..*..*..*
*..****..**********..*..*..*..*..*..****..*..****..****..*************..*..****..*..****..*
*..*..*..*........*..*..*..*..*..*..*..*..*..*..............*..............*..*..*........*
****..****..*******..****..**********..*..*..****..****..*******************..*..*******..*
*.....*.....*.....*.....*.....*..*........*..*.....*.....*........*..*...........*..*.....*
*..****..****..*******..*..*..*..****..**********..****..*..*******..*..****..****..****..*
*...........*........*..*..*..*..............*..*..*.....*.....*..*..*..*.....*...........*
****..**********..*..*..*..****..*..*******..*..****..*..*..****..*..*..*******..****..*..*
*..*.....*........*.....*..*.....*........*..*..*..*..*..............*.....*.....*..*..*..*
*..*..*..****..**********..*..****..****..****..*..**********..*..****************..*..****
*..*..*........*...........*..*.....*...........*.....*..*.....*..*.....*.....*..*.....*..*
*..*..*******..****..****..****..**********..*******..*..****..*******..*..****..****..*..*
*........*..*.....*..*.....*...........*.....*..*..*.....*.....*...........*..............*
**********..*******..*************************..*..*..*..*******..*************..**********
*..*..............*........*..*.....*...........*..*..*.....*.....*........*..*..*..*.....*
*..*******..*..*..*******..*..****..*..*..****..*..****..*******..*..****..*..*..*..****..*
*..*........*..*.....*........*.....*..*..*..*..............*.....*..*..*........*.....*..*
*..*..*..*******..*******..****..****..****..*..*..*************..****..****..****..****..*
*.....*..*..*...........*........*..*.....*..*..*..*........*..*..*...........*..*..*.....*
*******..*..*************..*******..*..****..**********..*..*..*..*..****..*..*..*..*..****
*.....*.....*..*.....*..*.......................*........*..*.....*.....*..*..*..*.....*..*
*..****..****..*..****..*******..*..*******..****..**********..****..*..*******..****..*..*
*.....*.....*........*..*..*..*..*.....*..*........*..*.....*.....*..*........*...........*
*..****..*******..*..*..*..*..*..*******..****..****..****..****..*..*..*******..**********
*..............*..*.....*..*.....*..*.....*.....*.....*...........*..*..*..*........*..*..*
*..*..*******..****..****..****..*..*..*..*..*..*..*..****..*..**********..****..*..*..*..*
*..*.....*.....*.....*..*........*..*..*.....*.....*.....*..*..*..*...........*..*..*.....*
*..**********..*..*..*..*******..*..****..**********..*..*..*..*..****..*..*******..*..*..*
*..*..*........*..*.....*..*...........*..*........*..*..*..*..*..*.....*.....*........*..*
*..*..****************..*..*..*******..*..*..*..*..****..*..****..*******..*..*..****..****
*..............*..............*.....*..*.....*..*..*.................*..*..*.....*..*.....*
*..****..****..****..****..*..****..*..*..*..*************..****..****..*..****..*..*******
*..*..*..*........*.....*..*........*..*..*...........*..*.....*..............*.....*.....*
*..*..****..****..*******..****************..*..****..*..*******..*************..*..*..****
*........*..*..*........*.....*..*..*........*.....*...........*..*.....*..*..*..*..*.....*
*..****..*..*..*******..****..*..*..****..*..*******..*..*************..*..*..*..*..****..*
*..*.....*..*....................*........*..*........*........*.................*........
****************************************************************************************..
