..*************************************
......*...*...........*.....*...*.....*
***.***.*.*.*********.*.*.*.*.*.*.***.*
*.....*.*.*.....*.*...*.*.*.*.*.*.*...*
*.*******.***.***.*.*******.*.***.*.***
*...*.....*.*.*...*.*...*.*.......*.*.*
*.***.*.*.*.*.*.***.*.*.*.*.*.*.***.*.*
*.*...*.*.*.....*.*.*.*.*...*.*.*.....*
*.*****.*****.*.*.*****.***.***.*.***.*
*.*.*.....*.*.*...*.*.*...*...*.*.*.*.*
*.*.*.***.*.***.*.*.*.*.*****.*****.*.*
*...*.*.*.......*.......*.....*...*...*
***.*.*.*.*.*.*.***********.*****.*.***
*.....*.*.*.*.*...*.*...*.....*.......*
*.*****.***.*****.*.***.*********.*****
*.*.....*.*.*.....*.........*.....*...*
*.*.*****.*.*.*********.*.*.*****.*.***
*.....*...*.*.*.....*...*.*...*.*.*...*
*.*.*****.***.*.***.*********.*.*.*.***
*.*...*...*.......*.*.......*.*.*.*...*
*.***.*.*****.***.*********.*.*.*.*.*.*
*.*.*.*.*...*...*.................*.*.*
*.*.***.*.*.*.*******.***.***.*.***.*.*
*.*...*...*.......*.*.*.....*.*.*.*.*.*
*.***.*.*.*.***.*.*.*******.***.*.***.*
*.....*.*.*.*...*.....*.......*.......
*************************************.
