...****************************************************************************************
...*....................*..............*...........*..............*........*..............*
*..****..*******..*******..*..*..*..*..*..*******..*..*******..*..****..*******..****..****
*...........*...........*..*..*..*..*..*.....*.....*..*........*..*..............*..*.....*
*..*..*******..*..*..*******..**********..*******..*******..*..*..*******..*******..*..****
*..*..*..*.....*..*........*..*..*.....*.....*..*..*.....*..*..*.....*...........*........*
*******..**********..*..*..*..*..****..*..*..*..*..*..****..****..****..****..*******..****
*........*..*........*..*.................*..*.....*.....*..*..*.....*..*........*..*.....*
*******..*..*..*..**********************..*..****..*..*..*..*..*..*************..*..*******
*.....*........*..*..*.................*..*.....*..*..*..*.....*..*.....*.................*
*..**********..****..**********..*******..*..****..****..****..****..*******..*..*..****..*
*.......................*..*..............*..*........*.....*...........*..*..*..*.....*..*
*..*..****..****..*******..*******..**********..****..*..*******..****..*..*******..*..****
*..*..*........*..............*.....*..*.....*..*..*.....*..*..*.....*.....*..*..*..*..*..*
*******..****..**********..*..*..****..*..*******..*..****..*..**********..*..*..****..*..*
*.....*..*..*..*..*........*..*..*.....*..............*..*..............*........*..*.....*
****..****..****..*..**********..****..*..*******..****..****..*..****..*..*..****..*..****
*.................*...........*..*..*..*........*........*.....*..*........*.....*........*
*..*..****..*..*..*..*..****..****..*..*******..*..****..****..*************..****..*..*..*
*..*..*.....*..*.....*..*..*.....*..............*..*..*..*..*..*..*..............*..*..*..*
*..**********..****..****..**********************..*..*..*..*..*..*..****..****..*..****..*
*..*.....*........*..*..............*...........*..*.....*..*..*..*..*.....*..*..*.....*..*
*..****..****..*******..****..*************..*..*******..*..****..*******..*..*..*..*******
*........*.....*..*.....*..*........*........*..*..*..*.....*..*.....*.....*.....*..*.....*
****************..*..****..*************..*******..*..*..*..*..*..*******..*******..****..*
*..*..*..................................................*.....*........*.................*
*..*..*..*************..**********************..****..*..*************..****..*..*******..*
*.....*.....*...........*...........*..*.....*..*.....*.....*...........*..*..*........*..*
****..****..****..****..****..****..*..****..*..**********..*******..****..****..*******..*
*.....*..*..*..*..*..*..*........*.....*...........*..*..*........*.....*...........*..*..*
*..****..****..****..*..**********..*..*..*******..*..*..*..****..*..*************..*..*..*
*........*.....*..*.....*.....*.....*..*.....*..*..*...........*..*..*..............*.....*
****..*..*..*..*..*..****..*..*******..*******..*******..****..*..*..****..****..*******..*
*..*..*.....*..*........*..*..*...........*..*........*..*.....*..*.....*.....*.....*..*..*
*..****..*..*..*..****..*..*******..*******..*..*******..****..*******..*..**********..****
*........*..*........*........*........*.....*.....*..*.....*..*........*..*..*...........*
**********..****..****..****..*..*..****..****..*..*..*..*..****..****..*..*..****..*******
*...........*..*.....*.....*..*..*..............*........*.....*.....*........*...........*
*..*..*..****..****..*************..*******..*..*..*******..*******..****..****..****..****
*..*..*........*..*.....*..*..*..*.....*..*..*..*..*..*..*..*........*..*..*........*.....*
*******..****..*..*******..*..*..*******..*..****..*..*..*..****..****..*..****..**********
*.....*..*..*.....*..*..*....................*..*..*.....*.....*..*..*.....*........*..*..*
*..*******..*..****..*..****..*..*************..****..*..*..****..*..*..*******..*..*..*..*
*.....*.....*.....*...........*........*........*..*..*...........*.....*..*..*..*.....*..*
****..*..*..*..**********..*******..****..*..****..*..**********..****..*..*..*******..*..*
*..*.....*..*.....*.....*.....*...........*..*.....*.....*.....*.....*..*.....*...........*
*..****..****..****..****..*..*..*************..*******..*..****..****..*..*******..****..*
*..*.................*.....*..*.....*..*.....*..*........*.....*.....*...........*..*.....*
*..*******..****..****..*******..****..*..****..**********..****..*************..*******..*
*...........*........*.....*..............*.....*........*...........*..*..*...........*..*
*..*******..****..*************..*******..*..*..*******..*******..*..*..*..*******..*..*..*
*..*..*.....*..*..*.....*.....*..*..*..*.....*........*.....*..*..*...........*..*..*.....*
*..*..*******..****..*******..*..*..*..*..**********..****..*..*..*..****..****..*******..*
*...........*.....*..*.....*..*........*..*.....*..*..*..*........*..*...........*........*
*******..*******..*..*..*..*..*..*..****..*..****..****..*..*..*..*******..****..*..*******
*..*..*..*..*..*........*..*..*..*..*..*..*........*........*..*..*..*..*..*.....*.....*..*
*..*..****..*..*..****..****..*******..****..****..*..****..****..*..*..**********..****..*
*..*.....*........*........*.....*.....*.....*..*.....*..*.....*..*.......................*
*..****..*..*************..*..*..*..*..*..****..*******..****..****..*..*..**********..*..*
*........*........*.....*..*..*.....*...........*..*.....*..*..*..*..*..*..*.....*.....*..*
*..*******..****..*..****************..**********..*..****..*..*..*******..****..*******..*
*...........*..*...........*.....*.....*..*..*..*...........*..*..*..*........*...........*
*..**********..*..*..*******..*******..*..*..*..****..****..*..*..*..****..*************..*
*.....*.....*..*..*..*..*.....*..*.................*..*...........*..*........*........*..*
*..*******..*..****..*..*..****..**********..****************..****..****..*******..*..****
*..*..*.....*.....*........*..*.....*........*...........*........*.....*.....*.....*..*..*
*..*..*..*******..*..*..****..*..*..*..*******..****..*******..*******..****..*..*..****..*
*..*.....*.....*.....*..*.....*..*..*........*..*........*..*..*..*..............*........*
****..*******..****..*..*..****..*******************..*..*..****..*..*******..*..****..****
*........*..*........*....................*.....*.....*.....*..*..*..*........*..*........*
*..****..*..*******..*..*******..****..*..****..****..****..*..*..*..**********..****..*..*
*..*..*...........*..*........*..*.....*..*.....*........*..*..*..*..*........*..*..*..*..*
****..*..*..*******..****..*..*..*..****..*..****..**********..*..*..*..*******..*..*..****
*........*..*.....*..*.....*..*..*.....*.....*..*..............*...........*.....*..*.....*
*******..*******..*******..*..****************..**********..**********..**********..****..*
*........*...........*.....*.....*..*.....*.....*..*..*..*..*..*........*.....*..*........*
*..*..*..*..*************..*..****..*..*******..*..*..*..*..*..*..****..****..*..****..****
*..*..*..*.....*........*..*........*.................*.....*........*..*..............*..*
****..*******..*..*******..*..*..****************..****..*..*..****..*************..*..*..*
*.....*..*...........*..*..*..*........*...........*..*..*........*........*.....*..*..*..*
*..*..*..*..**********..****..****..*..****..*..****..****..****..**********..**********..*
*..*.....*.....*..*........*.....*..*.....*..*..*..*.....*..*..............*..*........*..*
*..****..****..*..*..****..*..**********..*..****..****..****..****..*******..*******..*..*
*..*..*.....*........*..*.....*.............................*..*........*.....*.....*.....*
****..*..*..*..****..*..****..****..*******************..*******..*..****..****..****..*..*
*........*..*..*...........*..*..*.....*..*..*........*...........*...........*........*..*
*******..*******..****..****..*..*..*..*..*..*******..****..**********..*******..*..*..****
*.....*.....*.....*........*..*..*..*..*....................*........*.....*..*..*..*.....*
*..*..*..****..*..*..****..*..*..*******..*..*******..*************..*..****..****..****..*
*..*...........*..*.....*..*...........*..*..*........*........*.....*.....*...........*..*
*..**********..*..**********..*..**********..*******..*..*******..****..****..****..****..*
*.....*........*.....*..*.....*..*.....*.....*..*...........*..*.................*.....*..*
*..****..*******..*..*..*******..*..**********..*..**********..****..*..****************..*
*..*..*........*..*..*.....*...........*........*.....*........*.....*..*.....*.....*.....*
*..*..****..*************..**********..*******..****..*..*..****..*******..*..*..****..****
*..*.....*..............*.................*..............*..*.....*..*.....*........*.....*
*..****..****..*******..*..**********..**********..**********..*..*..****..*..**********..*
*.....*........*........*..*..............*.....*..*.....*.....*..*..*..*..*.....*........*
*..****..**********..*..**********..****..****..*..*..****..****..*..*..*..*..****..****..*
*.....*..*...........*..*...........*...........*.....*........*..*........*........*.....
****************************************************************************************..
