...****************************************************************************************
.....................*..............*........*.....*...........*..*.....*...........*.....*
*..*..****..*************..*******..*******..****..*..*..*..*..*..*..*..*..*******..*..*..*
*..*..*..............*..*........*...........*..*.....*..*..*.....*..*..*........*.....*..*
*..*******..****..****..*..****..****..*******..*******..**********..****..**********..****
*..*..*.....*........*.....*..*..*..*.....*..*.....*..*........*..............*..*..*.....*
*..*..*..*..*******..****..*..****..*..****..*..*..*..*******..*..*************..*..****..*
*..*.....*........*...........*.....*..*..*..*..*........*.....*..*..............*..*..*..*
*******************..*..*..*******..*..*..*..*..****..*******..*..****..**********..*..****
*.....*..*.....*..*..*..*........*..............*.....*..*..*..*..*.....*..*..*...........*
*..****..*..****..*..*..*******..****..*..****..*******..*..*..*..*..*..*..*..*..****..*..*
*...........*.....*..*........*.....*..*..*...........*.....*.....*..*..*..*.....*.....*..*
*******..*******..*..*..****..*..****..*..*..*******..****..****..*..****..****..*******..*
*.....*..............*.....*..*..*.....*..*..*..............*..*...........*........*.....*
*..*******..**********..*..*************..*******************..*..*************..****..*..*
*........*........*.....*.....*........*.................*..............*..*........*..*..*
****..****..*******..*************..*******..****..****..*******..*..****..*..*************
*........*..*.....*..*........*..*..............*..*...........*..*........*...........*..*
*..*..****..****..*******..*..*..*..*************..*..****..*..*..**********..*******..*..*
*..*..*..............*..*..*..*.................*..*..*.....*...........*..*..*.....*.....*
*..*************..****..*..****..*..*..****************..*..*******..****..*..****..****..*
*........*...........*.....*.....*..*........*...........*..*..*..*..*..............*..*..*
*..**********..****..****..****..*******..*******************..*..****..*..*..****..*..*..*
*.................*.....*..............*..*........*........*........*..*..*.....*.....*..*
*..*..*..****************..*..****..*******..*************..*..****..****..*******..*******
*..*..*..............*.....*.....*.....*...........*..*.....*..*..*........*..*........*..*
*..*..**********..*******..*************..*..*******..*..*******..****..****..*..****..*..*
*..*........*.....*..............*..*..*..*........*...........*..............*..*........*
****..*..****..****..*************..*..*..****************..****..*..*..*******..**********
*..*..*..*........*.....*..*..*..*..*..*........*..*..............*..*..*.....*..*........*
*..****************..*..*..*..*..*..*..*..*..****..*******..*************..****..****..****
*.....*.....*..*.....*.....*...........*..*..*..*..*..*..*...........*.....*...........*..*
*..****..****..*******..**********..****..*..*..*..*..*..*..**********..*..*..****..*..*..*
*........*....................*...........*..*..............*........*..*.....*.....*.....*
*******..*..*..****..*..*************..*..****..****..****..****..*..*******..*..*..****..*
*..*........*..*.....*........*........*.....*.....*.....*.....*..*.....*..*..*..*..*.....*
*..*..****..*******..****..****..****..*..****..*..*******..*******..*..*..****..****..****
*.....*........*..*..*.....*........*..*..*.....*..*.....*..*..*.....*........*.....*.....*
*..*******..****..****..**********..*******..*..*******..*..*..****..*************..*..****
*.....*........*.....*..*........*...........*.....*..*..............*.....*.....*..*..*..*
*..****************..*..*..*..*..****..**********..*..****..**********..****..*******..*..*
*.....*........*.....*.....*..*.....*.....*..*..*........*..*..............*........*..*..*
*..*..*..****..****..*..*..*..*..*..****..*..*..****..*******..**********..*..*..****..*..*
*..*..*.....*..*........*..*..*..*...........*.................*........*.....*..*........*
*******..*************..**********..****..****..*..**********..*..****..****..****..****..*
*.....*.....*..............*..*.....*.....*.....*..*...........*.....*.....*.....*.....*..*
****..****..*..*******..*..*..*..*..****..*******************..*..**********..*************
*..*...........*..*.....*..*..*..*.....*..*..*..*........*...........*.....*..*........*..*
*..*************..*******..*..**********..*..*..*******..****..**********..****..****..*..*
*.....*........*..*........*..*........*..*.....*........*..*..*.....*..............*.....*
****..*..*******..*******..*..****..*..*******..*..*******..****..*******..****..****..*..*
*.....*........*..*...........*.....*..*.....*..*.....*..*..*........*.....*........*..*..*
*..*..*..*******..****..*******..****..****..*..*..****..*..****..****..****..*************
*..*..*..*..*.....*..*..*...........*..*.....*..*........*..*.....*..*..*.....*...........*
****..*..*..****..*..*..*..****..****..****..*..*..****..*..****..*..*..*******..*******..*
*..*..*........*.....*..*..*.....*..*........*..*.....*..........................*.....*..*
*..*..*..*..****..*..*..*..*******..****..*..*..*************..****..*************..*..*..*
*........*........*..*..*..*..*..*........*........*...........*...........*..*..*..*..*..*
*******************..*..****..*..*************..*..*******..*..*..*******..*..*..****..*..*
*..*..*..*........*..*..*..*........*..*........*.....*.....*..*.....*.....*...........*..*
*..*..*..****..****..*..*..*******..*..****..*************..**********..****..*..**********
*..*........*..*..*........*..............*..*.....*.....*..*.....*.....*.....*.....*.....*
*..*******..*..*..****..*..****..**********..*..*******..****..*******..****..****..****..*
*...........*...........*.....*.....*........*..*.....*....................*.....*........*
****..*******..****..*..*..*******..****..****..*..*..*..*******************..*******..*..*
*...........*..*.....*..*..*.................*..*..*..*.....*........*..*.....*.....*..*..*
*..****..****..****..****..*******..*******..*..*..****..*..*..*..*..*..*..*..****..****..*
*..*...........*.....*.....*...........*........*........*..*..*..*..*.....*..*.....*..*..*
*..****************..*..*..*..****..*******************..****..*************..****..*..****
*........*........*..*..*.....*........*.....*.....*..*.....*..*..*..*..*..*..*..*..*..*..*
*..*..*..*******..*..****************..*..*..****..*..*..****..*..*..*..*..*..*..*..*..*..*
*..*..*..*..............*.....*...........*........*........*..*..*..............*........*
*..*******..*******..*******..*******..****..**********..****..*..*******..****..*..****..*
*........*..*..*.....*.....*........*..*...........*...........*...........*..*........*..*
*..*..*******..****..*..****..****..*..*******..****..*..*..*..*..*..****..*..*************
*..*..*..*..*.....*..*...........*..*.....*...........*..*..*..*..*.....*........*........*
****..*..*..*..*************..*..**********..*..*..*******..*..*..*..****..*..**********..*
*..*..*.....*........*........*..*...........*..*........*..*.....*..*.....*.....*.....*..*
*..*..****..*..****..*..****..****..*..****..*..*******************..*..****..*..****..*..*
*........*.....*..*.....*.....*.....*.....*..*.....*.....*.....*.....*..*..*..*...........*
*..*******..****..****..****..****..****..*******..*..*..****..*..*******..*******..****..*
*..*..*........*.....*..*........*..*..*........*..*..*........*..............*........*..*
*..*..*..*..****..*..****..*..****..*..****..**********..*******..*..*..****..*******..****
*........*........*..*.....*..*.....*........*..*........*........*..*.....*..*..*........*
*******..*..****..*************..*************..*..****..*******..*..*******..*..*..*..****
*..*.....*..*.....*.....*.....*........*..*.....*.....*........*..*..*........*.....*.....*
*..*..*************..****..*..****..*..*..*..*..****..****************..*..**********..****
*..*..*..............*.....*.....*..*..*.....*....................*.....*..*..*..*........*
*..*..*******..*************..****..*******..*******..*..*..****..*******..*..*..*..****..*
*.....*.....*...........*...........*..*.....*..*..*..*..*.....*..*.....*..*........*.....*
*..*..*..*************..****..*..****..*******..*..*******..*..*******..*..****..*..****..*
*..*..*........*........*..*..*.....*...........*........*..*..*..*.....*.....*..*.....*..*
*..****..**********..****..****..*..*..*..**********..*..*..****..*..****..*************..*
*........*.....*.....*...........*..*..*..............*........*.....*..*.....*........*..*
*..*..*******..****..*************************..*..*******..*******..*..*..*******..*******
*..*.....*..............*.......................*..*.....*..*.....*.......................*
*..**********..****..**********..**********..*******..*******..****..*..*******..****..*..*
*...........*..*..*..*...........*........*..*.....*..*..*..*..*.....*..*.....*..*.....*..*
****..*******..*..*..*..****..****..*******..*..****..*..*..*..*..****..*..**********..****
*..............*.....*..*...........*.............................*.....*.................
****************************************************************************************..
