...****************************************************************************************
...............*........*.....*........*.....*..*..*..*...........*..*..............*.....*
*..*..*..****..****..****..*..*******..****..*..*..*..****..****..*..**********..****..****
*..*..*..*..*..*...........*..*........*.....*........*.....*.....*.....*........*.....*..*
*******..*..*..****..*..****..****..****..****..*******..****..*..*..*..*******..*..****..*
*.....*.....*..*..*..*.....*..*..*.....*........*........*..*..*.....*...........*.....*..*
*..*..****..****..****..*..****..****..*******..*******..*..**********************..****..*
*..*.....*..*.....*.....*........*.....*..*........*..*.....*....................*..*.....*
****..*..*..****..*************..****..*..****..*..*..****..*******..*..**********..****..*
*.....*..*........*.....*..*.....*..*..*..*.....*.................*..*..............*..*..*
****..*..*******..****..*..****..*..*..*..****..****..****..*..*..*..****..****..*..*..*..*
*..*..*........*..............*..*..*.....*..*.....*.....*..*..*........*.....*..*........*
*..*..*******..*..*..**********..*..*..*..*..****..*..*******..*..**********..****..*..*..*
*..*.....*..*..*..*..*..*..*...........*...........*.....*.....*.....*...........*..*..*..*
*..*..*..*..****..*..*..*..****..*******************..*..*******..****..****..****..*..****
*..*..*.....*..*..*..*.....*........*..*........*.....*........*.....*..*..*.....*..*..*..*
*..*..*..****..*..*******..****..****..*..*******..*..*..*..*..*******..*..**********..*..*
*.....*.....*.....*..........................*.....*..*..*..*..*.....*.....*..*..*.....*..*
****..*..*******..****..****..*..****..****..*..****..*..**********..*..****..*..*..*..*..*
*..*..*..*..*..*..*..*..*.....*.....*..*.....*..*..*..*..*..*........*..*.....*.....*..*..*
*..****..*..*..*..*..****..****..*******..*..****..*..****..*..*..****..*..*******..****..*
*........*...........*.....*..*..*........*.....*...........*..*.....*..*.....*..*........*
*..*..*..*..*******..*******..*..**********..*************..****..**********..*..*******..*
*..*..*..*........*..*...........*..*.................*..*.................*..............*
*******..*..*************..*..*..*..*..*************..*..*..*..****..**********..*..*******
*..*.................*.....*..*.....*...........*..*.....*..*..*........*........*........*
*..*************..*******..**********..****..*..*..****..*..*******..****..*******..*******
*........*..*.....*.................*.....*..*........*..*.....*..*..*..*..*.....*..*.....*
****..****..****..*..*..****************..*******************..*..*..*..*..****..*..*..*..*
*...........*..*.....*........*..*........*..*...........*.....*.....*........*........*..*
*******..*..*..****..****..*..*..****..*..*..**********..****..*..*******..*..*..*..****..*
*........*..*.....*..*.....*.....*.....*.................*.....*........*..*..*..*.....*..*
*..*..*..****..*..*******************..*..*..*..*******************..****..*************..*
*..*..*.....*..*..*..*.....*........*..*..*..*..*..............*........*.....*..*........*
**********..****..*..*..*..*..**********..****************..*..*..*..**********..*..*..****
*...........*..*........*..*........*.....*..*..*..*..*..*..*..*..*..*...........*..*.....*
*..****..****..*..*..**********..*..****..*..*..*..*..*..*..**********..*..****..****..****
*.....*..*.....*..*........*.....*........*.....*..*.....*..*..*........*.....*.....*.....*
****..*******..****..****..*..****..*..*..*..****..*..*..*..*..**********..*************..*
*.....*..*..*........*.....*.....*..*..*..*...........*..............*...........*........*
*..*..*..*..****..*******..**********..****..****************..****..*******..**********..*
*..*...........*........*..*..*.....*..*.....*...........*..*..*........*..............*..*
*******..****..*..****..****..****..*..*..*..****..****..*..*..*******..*..****..*******..*
*.....*..*...........*........*...........*..*.....*..*..*..*..*.....*..*..*..*........*..*
*..*..*************..****..****..****..*..*******..*..****..****..*..*..****..*..**********
*..*..*.....*.....*..*..*.....*.....*..*..*........*.....*........*..*........*.....*..*..*
****..*..*..****..****..****..****..*************..*..****..*..*..****..****..*..****..*..*
*........*..*.....*..*.....*........*..*..*........*..*.....*..*..*........*........*.....*
*..*..*..*******..*..*..*..*..****..*..*..*******..*..*..*******..****..*******..****..****
*..*..*........*........*..*..*.....*...........*..............*..*.....*..*........*.....*
*..*..*******..*..****..*******************..****..****..****..*..****..*..****..*..*..****
*..*.....*........*..*..*.....*........*.....*.....*.....*.....*..*.....*.....*..*.....*..*
****..**********..*..****..*******..****..*..****..**********..*..**********..*..****..*..*
*..*.....*..*.....*.....*..............*..*...........*..*.....*........*..*........*.....*
*..*..*..*..*..*..*..****..****..****..*******..****..*..**********..****..*************..*
*..*..*.....*..*........*..*.....*........*..*..*..............*..*..*...........*........*
*..****************..*******..*************..*************..****..*..*******..****..*..****
*.....*...........*..........................*..*.....*........*...........*........*..*..*
****..*..****..****..****..*************..****..*..****..*..*******..**********..*..****..*
*.....*..*.....*..*..*.....*...........*........*........*.....*........*........*........*
*..****..****..*..****..*..*..****..****..*************..****..*************..*************
*........*..............*..*.....*...........*..*..*........*..*........*.................*
*******..****************..*..*..**********..*..*..*..****..*..****..**********..*..****..*
*..*..*..*..*........*..*..*..*..*........*..............*..*.....*.....*........*..*.....*
*..*..****..*..****..*..**********..*..*..****..*******..*************..**********..****..*
*..............*....................*..*...........*..............*..*........*..*.....*..*
****..****..****..*..****..*..*******..*******..*..****..**********..*******..*..*******..*
*..*.....*.....*..*.....*..*..*.....*..*.....*..*..*.....*..*.............................*
*..**********..*..****..*..*..*..*..*******..*******..****..****..*..****..****..****..****
*...........*..*.....*..*..*.....*...........*.................*..*..*.....*..*..*..*.....*
*******..*..****..****..****..*..*..*******************..**********..****..*..*..*..****..*
*........*..*.....*..*..*.....*..*.....*..*........*........*.....*.....*..*.....*..*.....*
*..*******..*******..*..*..*..**********..*..**********..*******..****************..****..*
*.....*..*..............*..*...........*..............*..............*...........*.....*..*
*..****..*..*******..**********************..****..*******..****..*************..****..*..*
*.....*........*.....*........*..*........*.....*........*..*..*........*.....*..*........*
*..*..**********..*..*******..*..****..*..*******..****..****..*..*..*******..*..*..****..*
*..*.....*..*.....*..*.....*...........*..............*..*.....*..*..*..*...........*..*..*
****..*..*..****..****..****..****..*..*..*..*..*..*******..*******..*..*..*******..*..****
*..*..*..*.................*..*.....*..*..*..*..*.....*..............*.....*..*..*........*
*..*..*******..*******..*..****..****..*******..*******..****..****..****..*..*..*******..*
*..*..*........*........*..*..*..*..*........*..*.....*..*..*..*.....*..*..*.....*..*.....*
*..*..*******..****..****..*..*..*..*..*..*******..*******..*******..*..****..****..*..****
*.....*...........*.....*.....*..*.....*..............*..*..*...........*........*..*.....*
****..**********..**********..*..*******..*************..*..*******..*..*..*******..*..****
*..*..*...........*..*.....*........*..*........*..*...........*..*..*..*..*........*..*..*
*..**********..****..****..**********..*..*..****..****..*..*..*..*..****..*..****..*..*..*
*..*.....*..*.....*..............*........*..*..*..*.....*..*.....*.....*.....*..*.....*..*
*..*..****..*..****..****..*******..****..*..*..*..*..*******..*************..*..*******..*
*..............*........*..............*..*.....*.....*.....*.....*..*..*.....*........*..*
****..****..****..****..*..*******..*..*..*..*******..****..****..*..*..****..*..*******..*
*.....*.....*..*.....*..*..*..*.....*..*..*....................*.....*.....*.....*..*.....*
****..*..****..****..****..*..**********..*******************..*******..*..*..*..*..*..*..*
*.....*........*..*.....*..............*..*........*........*..*........*.....*..*.....*..*
****..*..*******..*..****..*************..****..*******..****..****..*..*..*************..*
*.....*..*..*..*..*..*........*.....*..*...........*.................*..*........*..*..*..*
*..*..****..*..*..**********..*..*..*..****..*..*******************..**********..*..*..*..*
*..*.....*...........*..*........*..*..*..*..*..*.......................*........*........*
*******..*..*******..*..****..*..*..*..*..*..****..*..****..*******..*******..*..*******..*
*..............*........*.....*..*..*...........*..*.....*........*.....*.....*...........
****************************************************************************************..
