*****************************
*.*...*.......*...*.*.*.....*
*.*.*.*******.***.*.*.*.***.*
*.*.*.*...............*...*.*
*.***.*.*.*****.***.*.***.***
*...*.*.*.....*...*.*.*...*.*
***.*.*.*.***.*********.*.*.*
*...*.*.*.*.*.......*...*...*
***.*.*.***.***.*****.*.*.***
*.......*.*...*.....*.*.*...*
*.*******.*.*.*.***.***.*****
*...*...*...*.....*.*.....*.*
*.*****.*.*.*.*.***.*****.*.*
*.*.*...*.*.*.*.*...*...*...*
***.*.*********.*****.***.*.*
*.*...*...*.......*...*.*.*.*
*.***.***.***.*******.*.*.***
*...*...........*.*.*.*.....*
*.***.*****.*.***.*.*.*.*.***
*.*.*.....*.*.*.....*...*...*
*.*.*.*.*.***.*.***.*.***.*.*
*.*.*.*.*.*.......*...*.*.*.*
*.*.*.*.***.*.*.***.***.***.*
*...*.*.*...*.*...*.*.*.*...*
*.*******.*.*********.*.*.*.*
*.......*.*.*...*.........*.*
*.*******.*.*.***.***.***.*.*
*...*.*.*.*.*.....*...*.*.*.*
*.*.*.*.***.***********.***.*
*.*...*...*.....*...*.*.*...*
***.***.*****.*.*.*.*.*.***.*
*.......*...*.*.*.*...*.*...*
*.*********.***.*.*****.*****
*.........*...*.............*
*.*.***.***.*.*.*.***.*.***.*
*.*...*.*.*.*.*.*...*.*.*...*
*.***.***.*.***.*****.*****.*
*.*.*.*.....*...*.*...*.....*
***.*.***.*.***.*.***.*.*.*.*
*.*.......*.*.*.*.....*.*.*.*
*.*.*.*.*****.***.*.*****.*.*
*...*.*.........*.*...*...*.*
***.*****.*.*.*.*****.*******
*...*.....*.*.*.*...*.*.....*
*.*****.*.***.***.***.*****.*
*.*...*.*.*.*.......*.*.....*
*.***.*****.*.***.*.*.*.*.*.*
*.*...*.*.......*.*.....*.*.*
*.***.*.*.***.*************.*
*.......*.*...........*.....*
*****************************