...****************************************************************************************
..................*..*........*..*.....*..............*..*........*........*.....*........*
*..**********..****..*..*..****..*..**********..*..****..****..*..****..*******..*..*******
*..*..*........*..*.....*.....*..*..*.....*..*..*........*.....*..*........*........*.....*
****..*..****..*..*..*..****..*..*..****..*..****..****..****..*******..**********..*..*..*
*..*.....*.....*..*..*.....*...........*...........*..*..*........*.....*..*........*..*..*
*..*******..****..*******..*..****..*************..*..**********..*..*..*..*..****..*..****
*........*..*..*..*........*..*..*..*..*..*........*..*.....*.....*..*.....*.....*.....*..*
*..*..****..*..*..*..*..*..*..*..*..*..*..*..*..****..*..*..****..*..*******..****..****..*
*..*........*.....*..*..*..*..*..*..*..*.....*.....*.....*.....*.....*..*........*..*.....*
**********..****..*..*..****..*..*..*..*******..****..*..*******..****..****..*..*******..*
*..*...........*.....*.....*..*..*.....*...........*..*...........*........*..*..*........*
*..****..*..*..****..**********..*..*************..*..*..*******..****..*..*..*..*..****..*
*.....*..*..*...........*..............*..............*.....*........*..*.....*........*..*
*..****..****..*******..****..*******..*******..****..*************..**********..**********
*..*.....*.....*...........*..*........*.....*..*..*..*..*........*.....*.................*
*..*..*************..*..****..****..*******..*..*..*..*..*..*************..****..*..*******
*..*..*.....*.....*..*..*.....*.....*...........*.....*..*....................*..*........*
*..*******..*..*..*..*******..*..****..**********..****..****..**********..*******..****..*
*..............*..*..*........*.................*.....*..*...........*..*.....*.....*..*..*
*..*..*..*******..*..****..****..*******..*..*******..*..**********..*..*..****..*..*..****
*..*..*........*........*..*..*.....*.....*..*.....*..*.................*..*..*..*..*.....*
*******..****..*************..*************..****..****..*..****..*..*******..*******..****
*..*.....*........*..*.....*........*....................*..*.....*..*..*........*..*.....*
*..****..****..****..*..****..****..****..**********..**********..****..*..****..*..*..****
*...........*..*..*........*.....*........*........*..*...........*..*..*..*..*.....*.....*
*..*******..****..*******..****************..*************..*******..*..****..*..****..*..*
*..*..*........*...........*..............*........*.....*........*..*..*..............*..*
*..*..**********..*..****..**********..**********..*..*..****..****..*..*******..****..****
*..*........*..*..*..*..*..*..*..*...........*..*.....*..*.....*..*.....*..*..*..*.....*..*
*..*..*******..*..*..*..*..*..*..**********..*..*..****..****..*..*..*..*..*..*..*******..*
*.................*..*..*........*.....*.....*.....*..*..*.....*.....*.....*..*...........*
****..*******..****..*..****..*******..****..*..*..*..****..*..*..****..*..*..**********..*
*.....*.....*.....*........*........*...........*.....*.....*.....*.....*.....*..*........*
*..*..*..*..****..*************..*******..*..*..*******************..**********..*..*******
*..*.....*.....*.....*..*.....*..*..*.....*..*..*..*.....*..*..*...........*........*.....*
*..****..****..*..****..****..*..*..*******..*..*..****..*..*..*..****..****..*..****..****
*..*.....*.....*.....*..*..*..*..............*..*..*........*..*..*.....*.....*..*.....*..*
*..*************..****..*..*..*******..****..****..****..****..****************..****..*..*
*.....*..*..............*........*..*..*..*.....*.....*....................*..*...........*
*..****..*..*..*..*..**********..*..****..****..*..*..*..*..****..****..*..*..****..*******
*........*..*..*..*...........*........*.....*..*..*..*..*..*........*..*..*..*...........*
*..*..**********..*******..*..*..*..****..****..****..****..****..****..*..*..*..****..****
*..*.....*.....*.....*..*..*.....*..*..*..*..*.....*..*..*.....*..*.....*...........*.....*
*..*..*..****..*******..*..*******..*..*..*..*..*..*..*..*..*******..****..*************..*
*..*..*.....*..*.....*.....*.....*..*..*..*.....*..*..............*.....*..*.....*..*.....*
****..****..*..****..****..****..****..*..*..**********..*******..****..****..*..*..*******
*........*........*..*..*.....*.....*..............*..*........*..*.....*.....*........*..*
*******..****..****..*..*..*******..*..*************..*..*..*************..****..*..****..*
*.....*.....*.....*..*........*..*..*..*...........*.....*...........*.....*.....*..*.....*
*..**********..*..*..*..*..****..*..*******..*..*..*******..**********..****..****..****..*
*..............*..*.....*...........*.....*..*..*..*..*..*.....*..*..*..*..*.....*..*.....*
*..*..*..**********..*******..*..*******..*******..*..*..*..****..*..*..*..*..****..****..*
*..*..*.....*........*..*.....*..*..............*........*........*..*.....*..*...........*
****************..****..*******..*..**********..*..*..*..*..****..*..*******..**********..*
*........*...........*..*..*........*..*........*..*..*........*.................*........*
*..*..*******..****..*..*..*******..*..****..****..****..*..****..****..*******..****..****
*..*.....*..*.....*..*........*..*........*...........*..*..*........*..*..*..*..*..*.....*
****..****..****..*******..*..*..*******..*******..**********..**********..*..*..*..****..*
*..*.....*.....*...........*..*.....*........*.....*..............*........*.....*........*
*..*..*******..****..**********..*..*..****..****..*..****..****..*..*************..*..****
*.....*..............*..*........*.....*..*..*.....*..*........*..*........*.....*..*.....*
****..**********..****..*******..*..****..**********************..*..*******..*************
*..............*.....*..*..*..*..*..*.....*..*..*.....*........*..*..............*........*
****..*******..*..****..*..*..*..*..****..*..*..*..*******..*..*******..*..*..****..*..*..*
*...........*...........*..*.....*..*.....*.................*..*........*..*.....*..*..*..*
*..****..****..****..****..****..****..*..*******..****..**********..****..****..*..****..*
*.....*..*..*.....*........*..*..*..*..*........*..*........*.....*..*.....*.....*..*.....*
*..*******..*..*******..****..****..*******..*..**********..*..*******..*******..*******..*
*..*..*.....*..*..............*.....*........*..*..*........*.................*.....*.....*
****..*..****..****..*..*******..*******..****..*..*..****************..*******..*..****..*
*..*........*..*..*..*..............*........*...........*.................*.....*..*.....*
*..*..****..*..*..**********..*..****..*..**********..****..**********..*..*******..*..****
*..*.....*..*.....*.....*..*..*..*..*..*..*..*.................*........*.....*.....*..*..*
*..*..*******..****..*..*..****..*..****..*..**********..*******..*******..*..*******..*..*
*..............*..*..*...........*...........*........*.....*.....*........*..*........*..*
**********..****..****..*******..*..****..****..*..****..*..*..****..****..*..****..*..*..*
*.....*........*........*.....*........*..*.....*........*..*..*.....*.....*..*..*..*.....*
*..****..*************..****..**********..*******..****..****..**********..****..****..****
*.....*..*........*..*........*........*..*...........*..*...........*...........*........*
****..*..*******..*..**********..*..*..*..****..****..**********..****..*..*..*..****..****
*.....*..*..*.....*..............*..*..*.....*..*.....*........*..*.....*..*..*.....*.....*
*..****..*..*..*..*..****..*..*..*******************..*..****..****..*******..****..****..*
*........*.....*.....*.....*..*..*........*.....*...........*..*.....*..*........*.....*..*
****..*******..*..****..*******..****..****..**********..*************..*************..*..*
*..............*..*..*..*.....*........*..*.....*........*...........*........*...........*
*..*..*******..*..*..****..*..*..*..****..*..*******..*..*******..****..*..*******..*..*..*
*..*.....*.....*...........*..*..*..*..............*..*..............*..*..*.....*..*..*..*
*..*************..*******..*..****************..**********************..*..*..*******..*..*
*.....*..*..............*..*........*.....*.....*..*.................*..*...........*..*..*
*..****..*..*************..*..****..*..*******..*..****..****..*..****..****************..*
*..*.....*.....*...........*.....*..*..*.....*..*...........*..*..*........*..............*
****..****..****..****..*..**********..****..*..****..*..****..**********..****..****..****
*..............*..*..*..*..*..*..*...........*........*.....*..*..............*.....*..*..*
****..*..*..*..****..*..****..*..*..**********..****..*..*..*************..****..*******..*
*.....*..*..*..*........*..*........*..*...........*..*..*.....*..*..*........*..*........*
*******..*************..*..*..*..*..*..*..****..*******..****..*..*..*..****..*..*******..*
*........*........*........*..*..*.....*..*.....*........*...........*..*..*..............*
****..*******..****..*..**********..*******..*..*..*..****..*******..*..*..****..*..*******
*...........*........*..*....................*..*..*..*...........*........*.....*........
****************************************************************************************..
